------*-
---*----
*-------
--*-----
--*-----
------*-
-------*
----*---