---*------
--------*-
-*--------
------*---
---------*
-*--------
---*------
*---------
-----*----
--------*-